      SO	 ./xpm/salut.yep
			
			
			F   220,100,0
EA./xpm/salut.yep
NO./xpm/salut.yep
	WE./xpm/salut.yep

	C255,30,0

11111
10001
10S01
11111